
MAP START
7X 3X 6X 4X 1X 3X 7X
4X 3X 2X 4X 7X 2X 4X
5X 7X 1X 2X 5X 3X 5X
3S 5X 3X 1X 3X 6X 7E
5X 1X 7X 5X 4X 2X 1X
7X 2X 4X 6X 2X 6X 3X
2X 4X 7X 3X 1X 4X 2X
MAP END