TOP 6
FRONT 4
LEFT 2

MAP START
4S 6X 2X 5X 1X 5X 2X 1X 7X 4X
5X 2X 1X 7X 4X 5X 2X 1X 7X 4X
6X 2X 3X 1X 5X 5X 2X 1X 7X 4X
6X 4X 6X 3X 6X 5X 2X 1X 7X 4X
5X 3X 4X 5X 1X 5X 2X 1X 7X 4X
3X 6X 7X 3X 3E 5X 2X 1X 7X 4X
MAP END
