TOP 6
FRONT 4
LEFT 2

MAP START
1S 2S 3S 4S 5S 6S 7S
1X 2X 3X 4X 5X 6X 7X
1X 2X 3X 4X 5X 6X 7X
1X 2X 3X 4X 5X 6X 7X
1X 2X 3X 4X 5X 6X 7X
1E 2E 3E 4E 5E 6E 7E
MAP END
